NO ./path_to_the_north_texture
SO ./path_to_the_south_texture
WE ./path_to_the_west_texture
EA ./path_to_the_east_texture

F 220,100,12
C 225,30,0

1111111111111111
1N00000100000001
1011101111000001
1010001011000001
1010000011000001
1010000011000001
1010100011000001
1010100011000001
1011101111000001
1000000000000001
1110111111000001
1110111111000001
1000000000000001
1110011111000001
1100000111110001
1111111111111111
