NO ./path_to_the_north_texture
SO ./path_to_the_south_texture
WE ./path_to_the_west_texture
EA ./path_to_the_east_texture

F 220,100,12
C 225,30,0

11111111111111111111111111111111111111111
10000000000000000000000000000000011111111
10000000000000000000000000000000000101001
10000000000000000000000000000000001000111
10000000000000000000000000000000010010111
10000000000000000000000000000000000000001
1000000000000000000000000000000000N000011
10000000000000000000000000000110000000101
10000000000000000000000000000000000000001
10000000000000000000000000000110000000001
10000000000000000000000000000000000000001
10000000000000000000000000000000000000001
10000000000000000000000000000000000000001
10000000000000000000000000000000000000001
10000000000000000000000000000000000000001
10000000000000000000000000000000000000001
10000000000000000000000000000000000000001
11111111111111111111111111111111111111111