NO ./path_to_the_north_texture
SO ./path_to_the_south_texture
WE ./path_to_the_west_texture
EA ./path_to_the_east_texture

F 220,100,12
C 225,30,0

11111111111111111111111111111111111111111
10000011111111111111111111111000011111111
10000011111111111111111111111000000101001
10000011111111111111111111111000001000111
10000011111111111111111111111000010010111
10000011111111111111111111111000000000001
1000001111111111111111111111100000N000011
11111111111111111111111111111110000000101
10000011111111111111111111111000000000001
10111111111111111111111111111110000000001
10000000000000000000000000000000000000001
10000000000000000000000000000000000000001
10000000000000000000000000000000000000001
10000000000000000000000000000000000000001
10000000000000000000000000000000000000001
10000000000000000000000000000000000000001
10000000000000000000000000000000000000001
11111111111111111111111111111111111111111