NO ./path_to_the_north_texture
SO ./path_to_the_south_texture
WE ./path_to_the_west_texture
EA ./path_to_the_east_texture

F 220,100,12
C 225,30,0

11111111111111
10110001111111
10000100101001
10110010010001
10110101001011
100100N0000001
10000101000011
10000010000101
10010001001011
10100101000111
10000101000011
11111111111111