NO textures/wall_1.xpm 
SO textures/wall_2.xpm

WE textures/wall_3.xpm
EA textures/wall_4.xpm

C 51,198,233
F 121,143, 255






   11111111111111111111111
111000000000000000000001
11111111111111111111111
11111111111110111111111
11111110 11N111111111111

11111111111111111111111