NO ./images/wall1.png
SO ./images/wall2.png
WE ./images/wall3.png
EA ./images/wall4.png

F 255,133,0
C 0,10,0

11111111111111111111111111
10110001111111111111111111
10000100101000000000000001
10110010010000000000000001
10110101001011111111111111
100100N0000000000000000001
10000101000011111111111111
10000010000100000000000001
10010001001011111111111111
10100101000111111111111111
10000101000011111111111111
11111111111111111111111111