NO ./images/wall1.png
SO ./images/wall2.png
WE ./images/wall3.png
EA ./images/wall4.png

F 255,133,0
C 0,10,0

11111111111111111111111111
10110000000000000000111111
10110000000111111111111111
10110000000000000000111111
1000010S101000000000000001
10110010010100000000011111
10110100101000001111111111
10010000000011100000000011
11111111111111111111111111