NO ./images/wall1.png
SO ./images/wall2.png
WE ./images/wall3.png
EA ./images/wall4.png

F 255,133,0,0
C 0,10,0

1111111111111
1011000111111
1000010S10101
1011001001001
1011010010101
1001000000001
1111111111111