NO ./images/wall06.png
SO ./images/steel.png
WE ./images/wall03.png
EA ./images/wall04.png

F 255,133,00
C 0,0,0 

11111111111111111111
10000000000000000001
10111111001111111001
10100001000010000001
10101010101010101001
10101010101010101001
10001000100010001001
10000000000000000001
10101011100011101001
1000100000N000001001
10000000000000000001
10101011101011101001
10101010101010101001
10100001000010000001
10111111001111111001
10000000000000000001
10010000000000000001
11111111111111111111
