NO ./images/wall04.png
EA ./images/steel1.png
SO ./images/wall05.png
WE ./images/wall03.png

C 0,0,150
F 255,123,145

111111 111
100001101
100S01001
101111001
111111111