NO ./images/wall04.png
SO ./images/steel1.png
WE ./images/wall03.png
EA ./images/steel1.png       

C 0,0,150
F 255,123,145

111111111111111
                  