NO ./images/wall_1.png
SO ./images/wall_2.png
WE ./images/wall_3.png
EA ./images/wall_4.png
F 123,133,14
C 122,25,150





1111111111111111111111111111
10110001111111111111111111
10110001111111111111011111
10000100101000000000000001
10110010010000000000000001
10110101001000000000000111
10010000000000000000000001
10000101000000000000001111
10000010000100S00000000001
10010001001000000000111111
10100101000111111111111111
10000101000011111111111111
11111111111111111111111111
