NO ./images/wall04.png

EA ./images/steel1.png
F 255,123,145
C 0,0,150
SO ./images/wall05.png
      
WE ./images/wall_03.png
         
             
       
1111111111111
1000000000001
1000000000001
100000N000001
1111111111111