NO ./images/wall1024.png
SO ./images/wall1024.png
WE ./images/wall1024.png
EA ./images/wall1024.png

C 0,0,150
F 255,133,0

11111111111111111111111111
10110001111111111111111111
10000100101000000000000001
10110010010000000000000001
10110101001000000000000111
100100N0000000000000000001
10000101000000000000001111
10000010000100000000000001
10010001001000000000111111
10100101000111111111111111
10000101000011111111111111
11111111111111111111111111