NO     ./images/wall_1.png    
SO ./images/wall_1.png
WE ./images/wall_1.png
EA  ./images/wall_1.png

F  20,20,20
C 200,200,200



1111111111  
1111111111
1000000001
1000000001
1000000001
1000000001
1000001001
1000N00001
1000000001
1000000001
111111111