

SO ./images/b.png
WE ./images/wall03.png
        
EA ./images/wall03.png


NO ./images/wall04.png

C 0,0,1
F 255,123,145




11111111111
10000000001
1000N000001
11111111111