NO ./images/wall04.png
SO ./images/steel1.png
WE ./images/wall03.png
EA ./images/steel.png

C 0,0,150
F 255,183,3


111111111111111111
100000000000000001
10000000000001111
10000001000011
10E0000C0000011
1000000101001111
1000000000000001
11111111111111111