NO ./images/wall04.png
SO ./images/steel1.png
WE ./images/wall03.png
EA ./images/steel.png

C 0,0,150
F 255,123,145


111111111111111
100000000000001
100000000000001
100000000000001
1000001C1000001         
100000000000001
1000000N0000001
111111111111111