NO ./images/wall04.png
SO ./images/steel1.png
WE ./images/wall03.png
EA ./images/steel.png        

C 0,0,150
F 255,183,3

11111111111111111111111111111111111111111111111111111111111111111111
1010001111111111111111111111111111111111111111111111111111111111111
1000100101000000000000000000100001000010000100000100000100000100001
10110010010000000000000000000100001000010000100000100000100000100001
10110101001000000000000110011100111001110011100011100011100011100111
10010000000000000000000000000100001000010000100000100000100000100001
10000101000000000000001110111101111011110111100111100111100111101111
10000010000100000000000000000100001000010000100000100000100000100001
10000010000100100000000000000100001000010000100000100000100000100001
10000010000101C100001010000000100001000010000100000100000100000100001
1000001000010010C000000000000100001000010000100000100000100000100001
10000010000100000000100000000100001000010000100000100100100000100111
10000010000100000000C00000000C00000000000000000000000000100000000001
10000010000100000000100000000100001000010000100000100100100000100001
10000010000100000000000000000100001000010000100000100000100000100111
1000001000010000001C100000000100001001C10000100000100000100000100001
1000001000010000000000000010000100001CSC010000010000010000010000111
1000001000010000001000000001000010000101001000001000001000001001111
10000010000100000000000000000100001000010000100000100000100000100001
10000010000100000000000000000100001001C10000100000100000100000100001
10000010000100000000000000000100001000010000100000100000100000100111
11111111111111111111111111111111111111111111111111111111111111111111
