NO ./images/wall04.png
SO ./images/steel1.png
WE ./images/wall03.png
EA ./images/steel.png        

C 0,0,150
F 255,123,145


1111111111111
1000000000001
1000000000001
1000000000001
1000001C10001
1000000000001
1000000N00001
1111111111111