NO ./images/wall1024.png
SO ./images/wall1024.png
WE ./images/wall1024.png
EA ./images/wall1024.png

F 255,133,0
C 0,0,0

1111111111111
1011000111111
1000010010101
10111 1001001
1011010010101
1001N00000001
1111111111111