NO ./images/wall04.png
SO ./images/steel1.png
WE ./images/wall03.png
EA ./images/steel1.png

C 0,0,150
F 255,123,145

1111111111111111111
1001001001001001001
10S1001001001001001
1001001001001001001
1001001000001001001
1000000000000000001
1000011111111000001
1111000000000001111
1000000101010000001
1111111111111111111